1111111111111111111111111111
1000X000C000000000C010010X01
1001011111000000001000010001
1XX10000C0000P00001CCCCCCCC1
100100X000000E00001010101001
10001111101100000C100000CCX1
1111111111111111111111111111