11111111
1PCX1E01
100000X1
11111111