1111111111111111111111111111111111111111
1EP00000000C000000000C00000000000000C001
1C000000000C0000000000000000000010001001
1011110C01100100011110001111000101110101
1010000001110100000110001001000100100101
101110C00101010C01110000100100C100000101
1010000001011100011000001001000010001001
1011110001001100011110001111000001110001
1C000CC0000000000000000C00000000001C0001
1111111111111111111111111111111111111111