11111111111111111111
10000000000000000001
1000CCC000000CCC0001
1000CEC000P00C1C0001
1000CCC000000CCC0001
10000000000000000001
11111111111111111111