11111111111111111111
1000000000P000E000C1
100000000000000000C1
11111111111111111111